..%..%....%%%%.%%%%%%.....%%%%%%.%%%.%....%%%%%%%..............%%%.............%%..............%%......%%%%%%...
...........%%.....%%%......%%%............%%%%%%%%......%.%%.%%%%%....%%%..%..%%%......%%.....%%%......%%%......
...........%%......%%......%%%.............%%%%%%......%%%%%%%%%%%....%%%%%%%%%%%......%%%....%%%%.....%%.......
..........%%%%.....%%%.....%%..............%%%%%%.....%%%%%%%%%%%%....%%%%%%%%%%%.....%%%%.....%%%.....%%%......
...........%%%....%%%%.....%%................%%%%.....%%%%%%%%..%.....%%%%%%.%%..%.....%%%....%.%......%.%......
%%..%..%%%%%%......%%......%%.....%%....%%.............%%.............%%%.............%%%%....................%%
%%%%%%%%%%%%%%....%%%......%%.....%%%%%%%%.............%%%............%%%.............%%%%.....................%
%%%%%%%%%%%%%%....%%%%....%%%.....%%%%%%%.............%%%%............%%%.............%%%%.....................%
%%%%%%.%%%%%%......%.%....%........%.%%%%..............%%%............%%%%............%%%.....................%%
%%%%%%.....%%.........................%%%.....%%.%%.%%%%%%......%...%%%%%%.....%.%.%%%%%%%.%%%%................%
%%%%%%.....%%%.........................%%......%%%%%%%%%%%....%%%%%%%%%%%%.....%%%%%%%%%%%%%%%%%%%.....%%%....%%
%%%%%%....%%%%........................%%%%....%%%%%%%%%%%.....%%%%%%%%%%%%.....%%%%%%%%%%%%%%%%%%......%%%.....%
....%%.....%%..........................%%%....%%%%.%....%.......%.%%..%%%.....%%.%.%%...%.%%.%%%%%.....%%%....%%
...........%%%.....%%..%%.%..%%..%............%%%%....................%%%......................%%.....%%%.......
...........%%......%%%%%%%%%%%%%%..............%%%....................%%%%.....................%%.....%%%%......
..........%%%%.....%%%%%%%%%%%%%%.............%%%%.....................%%.....................%%%%....%%%.......
.............%....%..%.%%.%%%%%%%%............%%%%....................%%%.....................%%%%.....%%%......
%.%%%%.....................%%%%%%%..........%%%%%%..%%...........%.....%%%....%...%%%%........%%%%.%%.%%%%....%%
%%%%%%.....................%%%%%%......%%%%%%%%%%%%%%%%%%%%%%%%%%......%%%%%%%%%%%%%%%%%%......%%%%%%%%%%.....%%
%%%%%%....................%%%%%%%......%%%%%%%%%%%%%%%%%%%%%%%%%%.....%%%%%%%%%%%%%%%%%%%%....%%%%%%%%%%%%.....%
%%%%%%.....................%..%%%%....%%......%%...%%.%%%%%%%%%%%......%%%.%%%...%....%%%.....%%..%.%.%%%%.....%
...............................%%..............................%%.....%%%.............%%%%.............%%%......
..........%%%%%%%%%%%.........%%%%.............................%%......%%..............%%%.............%%%......
..........%%%%%%%%%%%.........%%%%............................%%%%....%%%..............%%..............%%.......
..........%%%%%...%%%%.........%%..............................%%.....%%%%.............%%.............%%%%......
.%................%%%%%.......%%%.....%%..%%.....%%%%%%.%.....%%%%....%%%.......%.....%%%%.%%..%.......%%%....%%
%%................%%%%%%%......%%%.....%%%%%%%%%%%%%%%%%%.....%%%%.....%%%....%%%......%%%%%%%%%%%.....%%......%
%%.................%%%%%%......%%%....%%%%%%%%%%%%%%%%%%%%....%%%%....%%%%....%%%.....%%%%%%%%%%%......%%%.....%
%%..................%%%%%.....%........%%.%..%%%%%.%%%%.%%.....%%%....%%%%.....%%%......%..%%.%%%%.....%%%.....%
%%........%%%%%..%.....%%.....................%%%.............%%%..............%%..............%%.....%%%%.....%
%%........%%%%%%%......%%.....................%%%..............%%.............%%%..............%%.....%%%%....%%
%%.........%%%%%%......%%.....................%%%.............%%%..............%%.............%%%.....%%%%....%%
%.........%%%%%%%%....%%%......................%%..............%%.............%%%..............%%%....%%%.....%%
%%.........%%%%%%%....%%%.....%%.%.%%..%%.%%..%%%%.....%.%%%%%%%%%%..%....%%.%%%%.....%%.%..%.%%%......%%%....%%
%%........%%%%%%%%....%%%......%%%%%%%%%%%%%%%%%%%.....%%%%%%%%%%%%%%%%%%%%%%%%%%%.....%%%%%%%%%%%....%%%......%
%..........%%%%%%%....%%%......%%%%%%%%%%%%%%%%%%%.....%%%%%%%%%%%%%%%%%%%%%%%%%%%.....%%%%%%%%%%%....%%%.....%%
%.........%.%.%.%%....%%%......%...%..%%%%.%..%%......%%%%..%.%%%%%%.%%%.%..%%.%.......%%%%%%%%%%.....%%%.....%%
%.....................................%%%%.............%%%....%%%%....................%%%%0....%%.....%%%%.....%
%%....................................%%%%.............%%%.....%%......................%%......%%%....%%%.....%%
%%....................................%%%%............%%%.....%%%%....................%%%%....%%%......%%.....%%
%%.....................................%%..............%%%.....%%%.....................%%......%%.....%%%......%
%%..%.....................%%%%....%%%%%%%.....%%%%%%%%%%%%....%%%........%......%%.....%%%....%%%.....%%%......%
%%%%%%....................%%%%....%%%%%%%%.....%%%%%%%%%%.....%%%%....%%%......%%%.....%%.....%%%%.....%%%....%%
%%%%%.....................%%%%.....%%%%%%......%%%%%%%%%%......%%%....%%%%.....%%%.....%%%....%%%.....%%%%.....%
%%%%%.....................%%%%.....%%%%%%.....%....%.%...%............%%%.....%.%%.....%.......%%......%%.....%%
%%%%%%%%%...%%.%%%%%%%....%%%......%%%%%%%.............................%%%.............................%%.....%%
%%%%%%%%%%%%%%%%%%%%%.....%%%%.....%%%%%%%............................%%%%.............................%%.....%%
%%%%%%%%%%%%%%%%%%%%%%....%%%%....%%%%%%%%.............................%%%.............................%%......%
%%%.%..%%.%%.%%%%....%......%%....%.%.%..%............................%%%.............................%%%.....%.
...............................................%%.....%%%.%.%.%..%....%%%%....%%.%....%.%.%...%.%.%.%%%%%%%%.%..
..............................................%%%%....%%%%%%%%%%%%.....%%.....%%%%.....%%%%%%%%%%%%%%%%%%%%%%...
..............................................%%%%.....%%%%%%%%%%.....%%%%.....%%%....%%%%%%%%%%%%%%%%%%%%%%%%..
..............................................%%%%....%.%%..%%%.%.....%..%....%%%.....%...%%.%.%.%...%%%%%%%%%..
...%%....%...%.%%%%%.%%.%%%%.%%.%.%%%.....%%.%%%%%.............................%%.....................%%%%%%%%..
%%%%%%%%%%%%%%%%%%%%%%%%%%%%%%%%%%%%%......%%%%%%%.............................%%%....................%%%%%%%%%%
%%%%%%%%%%%%%%%%%%%%%%%%%%%%%%%%%%%%%.....%%%%%%%%............................%%%%.....................%%%%%%%%%
...%.%%.%%%%%.%%%%....%...%%%%.%%%..............%%.............................%%%......................%%%%%%%.
...........................%%..........................%%.....%%..%..%.%%%.....%%.......%%%%..%.%.%%......%%%%..
..........................%%%%........................%%%%....%%%%%%%%%%%......%%......%%%%%%%%%%%%%%......%%%..
...........................%%%........................%%%%....%%%%%%%%%%%%....%%%.....%%%%%%%%%%%%%%%%.....%%...
..........................%%%.........................%%%%....%%%......%.......%%%.......%%.%%%%%.%%%%.....%%%..
....%...%..%%.%...%.%......%%%%%..%.%......%%.....%...%%%%....................%%%%.................%%.....%%%...
..%%%%%%%%%%%%%%%%%%%......%%%%%%%%%%.....%%%%%%%%%%%%%%%%.....................%%%................%%%%.....%%%..
..%%%%%%%%%%%%%%%%%%%%....%%%%%%%%%%%......%%%%%%%%%%%%%%%....................%%%%................%%%.....%%%...
...%%%.%..%%%%.%..%%%.....%%.%%%..%%%%....%.%%.%%%...%%........................%%%................%%%%.....%%%..
..........%%%......%%.............%%%%....................%%%%....................................%%%.....%%%...
..........%%%%....%%%%.............%%%....................%%%.....................................%%%......%%...
..........%%%.....%%%%............%%%%.....................%%......................................%%%....%%%...
.........1%%%......%%.............%%%......................%%.....................................%%%%....%%%%..
...%.%.%.%%%%%.....%%%..%%.%.......%%%.%%%%%%......%.......%%%.%%.%.%%.%....%.....%%.%%%%.........%%%%.....%%...
...%%%%%%%%%%.....%%%%%%%%%%%.....%%%%%%%%%%%%....%%%......%%%%%%%%%%%%%%%%%%%....%%%%%%%%.........%%%.....%%%..
..%%%%%%%%%%%%.....%%%%%%%%%%......%%%%%%%%%%%....%%%......%%%%%%%%%%%%%%%%%%......%%%%%%%.........%%......%%...
.......%.%...%.....%.%...%%%%......%%%%%%%.%.......%%.....%%%.%%%.%%%%...%..%......%%%%%%%.........%......%%.%..
...........................%%%.....%%%.............%%%............%%%..............%%%%%%%......................
...........................%%%....%%%%.............%%.............%%%.............%%%%%%%.......................
...........................%%%....%%%%............%%%..............%%%.............%%%%%%%......................
...........................%%%.....%%..............%%..............%%.............%.%...%%......................
..%%%%.....%%.....%.......%%%.....%%%%....%.....%.%%%%.%%.%%......%%%......%..%%%%............%%%%%...%%%..%%%..
..%%%%.....%%%%%%%%%%%.....%%......%%......%%%%%%%%%%%%%%%%%%.....%%%%.....%%%%%%%............%%%%%%%%%%%%%%%...
...%%.....%%%%%%%%%%%......%%.....%%%%.....%%%%%%%%%%%%%%%%%%.....%%%%.....%%%%%%%............%%%%%%%%%%%%%%%%..
..%........%%%%.%..%%......%%%....%.......%%%%....%.%%%..%%%%%....%%%%....%%%.%%%%.............%.%.%...%..%.%%..
..........%%%%............%%%.............%%%..............%%%.................%%.......%.......................
..........%%%.............%%%..............%%.............%%%%................%%%.....%%%%......................
...........%%%............%%%.............%%%%............%%%.................%%%%.....%%.......................
...........%%%.............%%.............%%%.............%%%.................%........%%.......................
%%.%.%....%%%.....%%%.%...%%%%..%..%%%%...%%%........%%.%%%%%%%.%..%.....%............%%%..........%.%....%%.%.%
%%%%%......%%.....%%%%%%%%%%%%%%%%%%%%%%%%%%%%.....%%%%%%%%%%%%%%%%%%%%%%..............%%..........%%%.....%%%%%
%%%%%.....%%%.....%%%%%%%%%%%%%%%%%%%%%%%%%%%%.....%%%%%%%%%%%%%%%%%%%%%%..............%%%........%%%%.....%%%%%
%.%%%.....%%%.....%%.%%%.%.%..%.%%%%%%%%%%%%%%....%....%%%%%..%.%%%%%%%%%..............%%..........%%.....%%.%%.
..........%%%%.....................%%%.............................%%%%%%.....%%%..%..%%%%.........%%%..........
...........%%......................%%%.............................%%%%%%.....%%%%%%%%%%%%.........%%...........
..........%%%.....................%%%.............................%%%%%%%%....%%%%%%%%%%%..........%%...........
..........%%%%....................%%%.............................%%..%%%.....%%%%..%%%%%%.........%%%..........
...%%.%%.%%%%%....%%%%.%.....%.....%%......%%%%....%.%....%%..%%%%....%%%..............%%..........%%.......%%..
...%%%%%%%%%%%%%%%%%%%%%%%%%%.....%%%%....%%%%%%%%%%%......%%%%%%%....%%%%............%%%%........%%%.....%%%...
...%%%%%%%%%%%%%%%%%%%%%%%%%%......%%......%%%%%%%%%%%....%%%%%%%%.....%%.............%%%%........%%%%.....%%...
....%%.%.%%%%%.%.%.%%%.%..%%%......%%......%%%.%..%..%........%%%%....%%%%............%%%.........%%%%....%%%%..
...........%%%............%%%.............%%%%.................%%......%%%..%%%........%%%...%............%%%...
..........%%%%............%%%.............%%%..................%%......%%%%%%%%%%.....%%%%%%%%............%%%%..
...........%%%............%%%.............%%%%.................%%%....%%%%%%%%%%%%....%%%%%%%%.............%%...
...........%%%............%%%.............%%%%.................%.%....%%%%%%%.%%%%....%.....%%.............%%%..
..%..%%.%%%%%%....%%......%%%.......%%%%%.%%%.......%%.%%.............%%%%....%%%..............%%%%%%.....%%%...
...%%%%%%%%%%.....%%%%....%%%.....%%%%%%%%%%%%.....%%%%%%%............%%%%.....%%%.............%%%%%%%....%%%%..
...%%%%%%%%%%%.....%%.....%%%......%%%%%%%%%%.....%%%%%%%%............%%%......%%%.............%%%%%%%.....%%%..
...%%%.%..%.......%%%%....%%%......%%%.%..%%.........%%%%..............%%%....%%%.............%%%%%%%.....%.%%..
..%%%%............%%%%.....%%%.....%%%................%%%%....%%.%.....%%%....%%%%...%........%%%...............
...%%%............%%%%....%%%%.....%%%.................%%%.....%%......%%.....%%%%%%%%%%%......%%...............
..%%%%............%%%%....%%%.....%%%..................%%......%%%.....%%......%%%%%%%%%%%.....%%...............
...%%%.............%%%.....%%......%%%.................%......%%%.....%.......%%%%.%...%%......%%%..............
...%%%.....%%%....%%%%.....%%%%%%%%%%%.......%.%...............%%..............%%.............%%%.....%%%%%%%...
...%%%.....%%%%%%%%%%......%%%%%%%%%%.....%%%%%%%..............%%..............%%%............%%%.....%%%%%%%%..
...%%%....%%%%%%%%%%%.....%%%%%%%%%%%%....%%%%%%%%............%%%..............%%.............%%%......%%%%%%%..
