%%%%%...........%%%%%%%...........%%%%%
%%%%%.............................%%%%%
%%%%%.............................%%%%%
%%%%%.............................%%%%%
%%%%%............*.B.*............%%%%%
%%%%%.............................%%%%%
%%%%%..............*..............%%%%%
%%%%%.............................%%%%%
%%%%%.............................%%%%%
%%%%%............%...%............%%%%%
%%%%%.............%%%.............%%%%%
%%%%%*...........................*%%%%%
%%%%%.............%%%.............%%%%%
%%%%%............%...%............%%%%%
%%%%%.............................%%%%%
%%%%%.............................%%%%%
%%%%%..............*..............%%%%%
%%%%%.............................%%%%%
%%%%%............*.A.*............%%%%%
%%%%%.............................%%%%%
%%%%%.............................%%%%%
%%%%%.............................%%%%%
%%%%%...........%%%%%%%...........%%%%%
